ddddddddddddd
d4d4d4d4d4d4d
d4d4d4d4d4d4d
d4d4d494d4d4d
d4d4d3d3d4d4d
ddddd1d1ddddd
6d44d3d3d44d6
ddddd1d1ddddd
d4d4d434d4d4d
d4d4d3d3d4d4d
d4d4dz1yd4d4d
ddddd0s2ddddd

